1 2
0 0 0 0 0 0 0 0
0 1 1 0 1 1 0 0
0 1 1 4 6 1 0 0
0 1 5 1 5 1 0 0
0 1 0 4 0 1 0 0
0 1 5 6 6 1 1 0
0 0 0 4 1 1 1 0
0 0 0 1 1 1 1 0
0 0 0 0 0 0 0 0
